columns: 25
rows: 25
pushes: 6
position: 228
skulls: 278
map:
XXXXXXXXXXXXXXXXXXXXXXXXX
XSSXSSSSSSSSSSSSSSSSSSSSX
XSSSSSSSSSSSSSSSSSSSSXSSX
XSSSXSSSXSSSSSSSSSSSSSSSX
XSSSSXSSSSSSXSSSSSSSSSSSX
XSSSSSSSSSSSSSSSSSSSSXSSX
XSSSSSSSXSSSSSSSXSSSSSSSX
XSSSSSSSSSSSSSSSSSSSSSSSX
XSSXXSSSSSSSSSSSSSSSSSSSX
XSSSSSSSSSSSSSSSSSSSSSXSX
XSSXSSSSSSSSSSSSSSXSSSSSX
XSSSSSSSSSSSSXSSSSSSSSSSX
XSXDSSSSSSSSSSSSSSSSSSSSX
XSSSSSXSSSSXSSSSSSSSSSSSX
XSSSSSSSSSSSSSSSSSSSSSSXX
XSSSSSSSSSSSSSSSSSSSSSSSX
XSSSSSSXSSSSSSSXSSSSSSSSX
XSSSSSSSSSSSSSSSSSSSSSXSX
XSXSSSSSSSSSSSSSSSSSSSSSX
XSSSSSSSSSSSSSSSSSSSXSSSX
XSXSSSSSSSSSSXSSSSSSSSSSX
XSSSSSSSSSSSXSSSSSSSSSSSX
XSSSSSSSSSSSSSSSSXSSSSSSX
XSSSXSSSSSSSSSSSSSSSSSSXX
XXXXXXXXXXXXXXXXXXXXXXXXE