columns: 16
rows: 14
pushes: 1
position: 205
skulls: 141
map:
XXXXXXXXXXXXXXXE
XSSSSSSSXSSSSSXE
XSSSXSSSSSSSSSXE
XSSSSSSSSXSSSSXE
XSXSSSSSSSSSSSXE
XXSSSSSSXSSSSSXE
XSSSSSSSSSSSSXXX
XSSSSSXSSSSSSSSX
XSSXSSSSSSSSSSDX
XSSSSSSSSSSSSXXX
XSSSSSSXSSSSSSXE
XSSSSXSSSXSSSSXE
XSSSSSSSSSSSSSXE
XXXXXXXXXXXXXXXE